不能	bjnr_ba
班级	bfjk_baa
不了	bjle_bai
宝贝	bzbw_bao
不好	bjhz_bau
不敢	bjgf_bav
不但	bjdf_bi
不见	bjjm_bia
别人	bdrn_bii
不错	bjcl_bio
不少	bjez_biu
不会	bjhb_biv
不是	bjek_bo
不让	bjrp_boa
便是	bmek_boi
表情	bcqg_boo
不断	bjdt_bou
毕竟	bkjg_bov
必须	bkxl_bu
不用	bjyy_bua
别的	bdde_bui
爸爸	bsbs_buo
变得	bmde_buu
不知	bjfk_buv
不过	bjgl_bv
不到	bjdz_bva
不想	bjxx_bvi
本来	bnlh_bvo
变成	bmjr_bvu
不禁	bjjbv_bvv
才能	chnr_ca
曾经	crjg_caa
村子	cwzk_cai
沧桑	cpsp_cao
参加	cfjs_cau
村民	cwmb_cav
操作	czzl_ci
村里	cwlk_cia
此人	ckrn_cii
催促	cbcj_cio
从小	cyxc_ciu
从此	cyck_civ
此时	ckek_co
测试	ceek_coa
才是	chek_coi
匆忙	cymp_coo
材料	chlc_cou
此刻	ckke_cov
采用	chyy_cu
匆匆	cycy_cua
苍白	cpbh_cui
苍老	cplz_cuo
厕所	cesl_cuu
村长	cwqp_cuv
存在	cwzh_cv
参与	cfyl_cva
从事	cyek_cvi
从来	cylh_cvo
才有	chyd_cvu
从未	cyww_cvv
到了	dzle_da
大约	dsyh_daa
肚子	djzk_dai
淡淡	dfdf_dao
打架	dsjsi_dau
当即	dpjk_dav
多少	dlez_di
当中	dpfy_dia
大人	dsrn_dii
灯光	drgm_dio
动作	dyzl_diu
地上	dkep_div
但是	dfek_do
的话	dehq_doa
都是	ddek_doi
大家	dsjs_doo
弟弟	dkdk_dou
地方	dkfp_dov
当然	dprf_du
多么	dlme_dua
独自	djzku_dui
大爷	dsye_duo
等待	drdh_duu
打算	dsst_duv
东西	dyxk_dv
得到	dedz_dva
地下	dkxs_dvi
大哥	dsge_dvo
对面	dbmm_dvu
对于	dbyl_dvv
生活	erhl_ea
视线	ekxmo_eaa
身子	enzk_eai
深深	enen_eao
身边	enbm_eau
手臂	edbk_eav
时候	ekhd_ei
世界	ekjd_eia
是从	ekcy_eii
时光	ekgm_eio
双手	emed_eiu
身上	enep_eiv
时间	ekjmo_eo
说话	elhq_eoa
瞬间	ewjm_eoi
事情	ekqg_eoo
说着	elfe_eou
声音	eryb_eov
什么	enme_eu
舒服	ejfj_eua
似的	ekde_eui
十分	ekfn_euo
身后	enhd_euu
少年	eznm_euv
上面	epmm_ev
甚至	enfk_eva
剩下	erxs_evi
上来	eplh_evo
手机	edjk_evu
属于	ejyl_evv
只能	fknr_fa
纷纷	fnfn_faa
房子	fpzk_fai
否则	fdze_fao
只好	fkhz_fau
发展	fsqf_fav
这个	fege_fi
这里	felk_fia
众人	fyrn_fii
非常	fwjp_fio
直接	fkjd_fiu
桌上	flep_fiv
知道	fkdz_fo
放心	fpxb_foa
只是	fkek_foi
放学	fpxh_foo
之前	fkqm_fou
父亲	fjqb_fov
这么	feme_fu
疯狂	frkm_fua
转身	ften_fui
中考	fykz_fuo
之后	fkhd_fuu
这种	fefy_fuv
这样	feyp_fv
找到	fzdz_fva
只要	fkyz_fvi
发起	fsqk_fvo
只有	fkyd_fvu
发现	fsxm_fvv
更加	grjs_ga
高级	gzjk_gaa
公子	gyzku_gai
关注	gtqj_gao
姑娘	gjnx_gau
公司	gysk_gav
工作	gyzl_gi
刚刚	gpgp_gia
赶紧	gfjb_gii
各位	geww_gio
高手	gzed_giu
关上	gtep_giv
感觉	gfjh_go
告诉	gzsj_goa
更是	grek_goi
国家	gljs_goo
跟着	gnfe_gou
改变	ghbm_gov
关系	gtxk_gu
果然	glrf_gua
各自	gezk_gui
感受	gfed_guo
过后	glhd_guu
各种	gefy_guv
过去	glql_gv
感到	gfdz_gva
根本	gnbn_gvi
过来	gllh_gvo
尴尬	gfgs_gvu
关于	gtyl_gvv
还没	hhmw_ha
缓缓	htht_haa
孩子	hhzk_hai
还能	hhnr_hao
还好	hhhz_hau
喝酒	hejq_hav
好像	hzxxa_hi
怀里	hglk_hia
好人	hzrn_hii
黄金	hmjb_hio
好看	hzkf_hiu
如何	rjhe_hiv
还是	hhek_ho
或许	hlxl_hoa
哈哈	hsh_hoi
回家	hbjs_hoo
火焰	hlyf_hou
呵呵	hehe_hov
好的	hzde_hu
很多	hndl_hua
浑身	hwen_hui
或者	hlfe_huo
获得	hlde_huu
回答	hbds_huv
还有	hhyd_hv
回到	hbdz_hva
还要	hhyz_hvi
回来	hblh_hvo
好奇	hzqk_hvu
活动	hldy_hvv
继续	jkxl_ja
成绩	jrjk_jaa
除了	jjle_jai
绝对	jhdb_jao
姐姐	jdjd_jau
渐渐	jmjm_jav
几个	jkge_ji
结果	jdgl_jia
紧紧	jbjb_jii
经常	jgjp_jio
坚持	jmwk_jiu
机会	jkhb_jiv
就是	jqek_jo
惊讶	jgys_joa
出门	jjmn_joi
教室	jceku_joo
成为	jrww_jou
城市	jrek_jov
几乎	jkhj_ju
竟然	jgrf_jua
阶段	jddt_jui
进入	jbrj_juo
觉得	jhde_juu
就算	jqst_juv
今天	jbtm_jv
见到	jmdz_jva
就要	jqyz_jvi
出来	jjlh_jvo
见面	jmmm_jvu
出现	jjxm_jvv
可以	keyk_ka
口水	kdeb_kaa
看出	kfjj_kai
可能	kenr_kao
开始	khek_kau
看清	kfqg_kav
况且	kmqd_ki
看见	kfjm_kia
刻苦	kekj_kii
块钱	kgqm_kio
科技	kejk_kiu
快点	kgdm_kiv
可是	keek_ko
开心	khxb_koa
空间	kyjm_koi
肯定	kndg_koo
看着	kffe_kou
渴望	kewp_kov
可爱	kexhv_ku
快乐	kgle_kua
卡片	kspm_kui
开支	khfk_kuo
靠近	kzjb_kuu
空气	kyqk_kuv
看到	kfdz_kv
开车	khje_kva
快速	kgsj_kvi
看来	kflh_kvo
客厅	ketg_kvu
魁梧	kbwj_kvv
例如	lkrj_la
立马	lkms_laa
露出	ldjj_lai
练习	lmx_lao
老妈	lzms_lau
立即	lkjk_lav
两个	lxge_li
历史	lkek_lia
老人	lzrn_lii
两位	lxww_lio
老师	lzek_liu
脸上	lmep_liv
厉害	lkhh_lo
来说	lhel_loa
力量	lklx_loi
老头	lztd_loo
两只	lxfk_lou
立刻	lkke_lov
了解	lcjd_lu
联系	lmxk_lua
来自	lhzk_lui
老爸	lzbs_luo
懒得	lfde_luu
力气	lkqk_luv
里面	lkmm_lv
来到	lhdz_lva
留下	lqxs_lvi
离去	lkql_lvo
老板	lzbf_lvu
离开	lkkh_lvv
妈妈	msms_ma
梦乡	mrxxv_maa
妹子	mwzk_mai
面对	mmdb_mao
美女	mwnl_mau
勉强	mmqx_mav
每个	mwge_mi
默默	mlml_mia
某个	mdge_mii
目光	mjgm_mio
摸摸	mlmli_miu
马上	msep_miv
目前	mjqm_mo
名叫	mgjc_moa
明显	mgxm_moi
慢慢	mfmf_moo
面前	mmqm_mou
母亲	mjqb_mov
明白	mgbh_mu
门外	mnwh_mua
满脸	mflm_mui
摸索	mlsl_muo
矛盾	mzdw_muu
陌生	mler_muv
没有	mwyd_mv
马车	msje_mva
没事	mwek_mvi
模样	mjyp_mvo
忙碌	mplj_mvu
每天	mwtm_mvv
能力	nrlk_na
年纪	nmjk_naa
女孩	nlhh_nai
难以	nfyk_nao
努力	njlk_nau
农民	nymb_nav
你们	nkmn_ni
哪里	nsl_nia
那个	nsge_nii
那位	nsww_nio
难看	nfkf_niu
那些	nsxd_niv
难道	nfdz_no
内心	nwxb_noa
能量	nrlx_noi
内容	nwry_noo
怒火	njhl_nou
内部	nwbj_nov
那么	nsme_nu
能够	nrgd_nua
你的	nkde_nui
难受	nfed_nuo
难得	nfde_nuu
那种	nsfy_nuv
那样	nsyp_nv
年轻	nmqg_nva
难过	nfgl_nvi
拿来	nslh_nvo
女友	nlyd_nvu
那天	nstm_nvv
普通	pjty_pa
婆婆	plpl_paa
胖子	ppzk_pai
平淡	pgdf_pao
旁边	ppbm_pau
啤酒	pkjq_pav
配合	pwhe_pi
苹果	pggl_pia
评价	pgjs_pii
平常	pgjp_pio
拍拍	phph_piu
拼命	pbmg_piv
漂亮	pclx_po
评论	pglw_poa
平日	pgrk_poi
凭空	pgky_poo
培养	pwyp_pou
片刻	pmke_pov
品质	pbfk_pu
平凡	pgff_pua
品牌	pbph_pui
平分	pgfnv_puo
屁股	pkgj_puu
皮肤	pkfj_puv
朋友	pryd_pv
跑到	pzdz_pva
皮鞋	pkxd_pvi
破坏	plhg_pvo
趴在	pszh_pvu
平静	pgjg_pvv
正好	qrhz_qa
情绪	qgxl_qaa
妻子	qkzk_qai
前台	qmth_qao
强忍	qxrna_qau
逐渐	qjjm_qav
这些	fexd_qi
其他	qkts_qia
整个	qrge_qii
正常	qrjp_qio
主任	qjrno_qiu
其余	qkyl_qiv
其实	qkek_qo
注视	qjeka_qoa
真是	qnek_qoi
确实	qhek_qoo
正义	qryk_qou
情况	qgkm_qov
准备	qwbw_qu
欺负	qkfj_qua
真的	qnde_qui
全都	qtdd_quo
期待	qkdh_quu
青年	qgnm_quv
起来	qklh_qv
轻轻	qgqg_qva
真正	qnqr_qvi
前来	qmlh_qvo
正在	qrzh_qvu
清楚	qgjj_qvv
人民	rnmb_ra
热水	reeb_raa
日子	rkzk_rai
人流	rnlq_rao
人潮	rnjz_rau
人群	rnqw_rav
如果	rjgl_ri
如同	rjty_ria
人人	rnrn_rii
如今	rjjb_rio
软件	rtjm_riu
认为	rnww_ro
认识	rnek_roa
容易	ryyk_roi
人家	rnjs_roo
人类	rnlw_rou
容颜	ryyf_rov
然后	rfhd_ru
仍然	rrrf_rua
热血	rexh_rui
认真	rnqn_ruo
日后	rkhd_ruu
人生	rner_ruv
然而	rfxj_rv
柔软	rdrt_rva
人才	rnch_rvi
认可	rnke_rvo
偌大	rlds_rvu
让开	rpkh_rvv
所以	slyk_sa
送给	sygw_saa
算了	stle_sai
三流	sflq_sao
散发	sffs_sau
随即	sbjka_sav
三个	sfge_si
三岁	sfsb_sia
四个	skge_sii
思念	sknm_sio
随手	sbed_siu
宿舍	sjee_siv
随着	sbfe_so
所谓	slww_soa
算是	stek_soi
索性	slxg_soo
岁数	sbej_sou
速度	sjdj_sov
虽然	sbrf_su
四周	skfd_sua
碎片	sbpm_sui
似乎	skhj_suo
随后	sbhd_suu
三年	sfnm_suv
所有	slyd_sv
送到	sydz_sva
苏醒	sjxg_svi
送来	sylh_svo
司机	skjk_svu
三天	sftm_svv
提出	tkjj_ta
通红	tyhy_taa
太阳	thyp_tai
天赋	tmfj_tao
头发	tdfs_tau
唾沫	tlme_tav
他们	tsmn_ti
听见	tgjm_tia
痛苦	tykj_tii
她们	tsmna_tio
条件	tcjm_tiu
停止	tgfk_tiv
特别	tebd_to
听说	tgel_toa
同时	tyek_toi
天空	tmky_too
听着	tgfe_tou
同意	tyyk_tov
他的	tsde_tu
突然	tjrf_tua
叹息	tfxk_tui
头脑	tdnz_tuo
体质	tkfk_tuu
通知	tyfk_tuv
天天	tmtm_tv
听到	tgdz_tva
通过	tygl_tvi
同样	tyyp_tvo
讨厌	tzyf_tvu
推开	tbkh_tvv
为了	wwle_wa
网络	wpll_waa
充满	wymf_wai
温柔	wnrd_wao
无力	wjlkv_wau
无法	wjfs_wav
我们	wlmn_wi
位置	wwfk_wia
五个	wjge_wii
微信	wwxb_wio
文化	wnhq_wiu
晚上	wfep_wiv
问题	wntk_wo
忘记	wpjk_woa
温暖	wnnt_woi
晚安	wfxf_woo
完美	wfmw_wou
闻言	wnyfo_wov
我的	wlde_wu
吃饭	wkff_wua
冲向	wyxx_wui
无辜	wjgj_wuo
微微	wwww_wuu
微笑	wwxc_wuv
完成	wfjr_wv
无比	wjbk_wva
无聊	wjlc_wvi
未来	wwlh_wvo
无奈	wjnh_wvu
唯一	wwyk_wvv
喜欢	xkht_xa
系统	xkty_xaa
小子	xczk_xai
学习	xhxk_xao
小姐	xcjd_xau
而已	xjyk_xav
而且	xjqd_xi
心里	xblk_xia
二人	xjrn_xii
相信	xxxb_xio
选择	xtze_xiu
安全	xfqt_xiv
而是	xjek_xo
谢谢	xdxd_xoa
像是	xxek_xoi
心情	xbqg_xoo
想着	xxfe_xou
希望	xkwp_xov
许多	xldl_xu
想象	xxxxv_xua
休息	xqxk_xui
享受	xxed_xuo
显得	xmde_xuu
学生	xher_xuv
现在	xmzh_xv
想到	xxdz_xva
需要	xlyz_xvi
下来	xslh_xvo
兴奋	xgfn_xvu
安静	xfjg_xvv
已经	ykjg_ya
一丝	ykskv_yaa
样子	ypzk_yai
游戏	ydxk_yao
一边	ykbm_yau
一张	ykqp_yav
一个	ykge_yi
眼睛	yfjg_yia
一幕	ykmj_yii
一位	ykwwv_yio
一把	ykbs_yiu
有些	ydxd_yiv
因为	ybww_yo
应该	yggh_yoa
也是	yeek_yoi
一定	ykdg_yoo
以前	ykqm_you
一次	ykck_yov
以后	ykhd_yu
一句	ykjlv_yua
有的	ydde_yui
一直	ykfk_yuo
一般	ykbf_yuu
一种	ykfy_yuv
一样	ykyp_yv
一切	ykqd_yva
一下	ykxs_yvi
一起	ykqk_yvo
拥有	yyyd_yvu
一天	yktm_yvv
自己	zkjk_za
最终	zbfy_zaa
走出	zdjj_zai
足以	zjyk_zao
最好	zbhz_zau
早已	zzyk_zav
暂且	zfqd_zi
再见	zhjm_zia
自从	zkcy_zii
咱们	zfmn_zio
左手	zled_ziu
早上	zzep_ziv
作为	zlww_zo
再说	zhel_zoa
总是	zyek_zoi
在家	zhjs_zoo
字数	zkej_zou
再次	zhck_zov
怎么	znme_zu
自然	zkrf_zua
走向	zdxx_zui
作者	zlfe_zuo
最后	zbhd_zuu
总算	zyst_zuv
怎样	znyp_zv
做到	zldz_zva
坐下	zlxs_zvi
走来	zdlh_zvo
坐在	zlzh_zvu
走进	zdjb_zvv
表示	bcek_be
并且	bgqd_bq
不同	bjty_bt
不行	bjxg_bx
不要	bjyz_by
错过	clgl_cg
聪明	cymg_cm
采取	chql_cq
操心	czxb_cx
电脑	dmnz_dn
大小	dsxc_dx
上次	epck_ec
说明	elmg_em
使用	ekyy_ey
服从	fjcy_fc
中国	fygl_fg
符合	fjhe_fh
父母	fjmj_fm
刚才	gpch_gc
赶快	gfkg_gk
光明	gmmg_gm
花草	hqcz_hc
很快	hnkg_hk
后面	hdmm_hm
快餐	kgcf_kc
可靠	kekz_kk
开门	khmn_km
两年	lxnm_ln
明天	mgtm_mt
梦想	mrxx_mx
满意	mfyk_my
哪怕	nsps_np
平时	pgek_pe
脾气	pkqk_pq
平台	pgth_pt
平安	pgxf_px
拼音	pbyb_py
如此	rjck_rc
人工	rngy_rg
人们	rnmn_rm
日期	rkqk_rq
染色	rfse_rs
热线	rexm_rx
三次	sfck_sc
搜狗	sdgd_sg
算吗	stmsu_sm
索取	slql_sq
思想	skxx_sx
太难	thnf_tn
提前	tkqm_tq
同学	tyxh_tx
为此	wwck_wc
外面	whmm_wm
完全	wfqt_wq
因此	ybck_yc
以及	ykjk_yj
郁闷	ylmn_ym
一年	yknm_yn
要求	yzqq_yq
有人	ydrn_yr
以下	ykxsa_yx
因而	ybxj_yx
字词	zkck_zc
做饭	zlff_zf
字根	zkgn_zg
在吗	zhms_zm
组长	zjqp_zq
昨天	zltm_zt
仔细	zkxk_zx
